31 24
200 200
4  4  4  4  4  4  4  4  4  4  4  4  4  4  4  4  4  4  4  4  4  4  4  4  4  4  4  4  4  4  4
4  4  4  4  4  4  4  4  2  2  2  0  0  0  0  0  0  0  0  0  0  0  0  0  0  0  0  3  3  3  4
4  4  0  0  0 22  7  4  2  2  2  0  0  0 -5  0  0  0  0 -5  0  0  0  0 -4  0  5  5  5  3  4
4  4  0  0  0  7  5  4  2  2  2  0  0  0  0  0  0  0  0  0  0  0  0  0  0  0  5  5  5  3  4
4  4  0  0  0  0  0  4  2  2  2  0  0  0  0  0  0  0  0  0  0  0 -5  0  0  0  0  0  0  3  4
4  4  0  3  3  3  3  4  2  2  2  0  0  0  0  0  0  0  0  0  0  0  0  0  0  0  0  0  0  0  4
4  0  0  3  3  3  3  0  0  0  0  3  0  0  0  0  0  3  3  0  0  0  0  0  3  3  3  3  0  0  4
4  0  0  3  3  3  3  0  0  0  3  3  5  5  0  0  0  3  3  0  0  5  5  0  3  3  3  3  0  0  4
4  0  0  3  3  3  3  0  0  0  3  3  5  5  0  0  0  3  3  7  7  5  5  0  3  3  3  3  0  0  4
4  0  0  0  0  0  0  0  0  0  3  3  3  6  6  0  0  3  3  7  7  5  5  0  6  6  0  0  0  0  4
4  0  0  0  0  0  0  0  0  0  0  0  0  0  0  0  0  3  3  0  0  0  0  0  6  6  0  0  0  0  4
4  0  0  0  0  0  0  0  0  0  0  0  0  0  0  0  0  3  3  0  0  0  0  0  3  3  3  3  0  0  4
4  0  0  0  0  0 -4  0  0  0  0  0  0 -5  0  0  0  2  2  2  0  0  0  0  3  3  0  0  0  0  4
4  0 -5  0  0  0  0  0 -5  0  0  0  0  0  0  0  0  2  2  2  0  0  0  0  3  3  0  0  0  0  4
4  0  0  0  0  1  1  0  0  0  0  0  0  0  0 -4  0  0  0  0  0  0  0  0  0  0  0  0  0  0  4
4  0  0  0  1  1  1  1  0  0  3  0  0  0  0  0  0  0  0  0  0  0  0  0  0  0  0  0  0  0  4
4  0  0  0  1  1  1  1  1  0  3  0  0  0  0  0  0  0  0  0  0  1  0  0  0  0  0  0  0  0  4
4  0  0  2  0 -5  0  0  3  3  3  0  0  0  0  0  3  3  3  3  3  0  0  0  0  0  0  0  0  3  4
4  2  0  2  2  0  0  0  0  0  0  0  0 -4  0  0  3  0  0  0  0  0  0 -3  0  5  5  0  0  3  4
4  2  7  2  2  2  0  0  0  0  0  0  0  0  0  0  3  0  0  0  0  0  0  0  0  5  5  0  0  3  4
4  2  7  2  2  2  0  0  0 -5  0  0  0  0  0  0  3  0  0  0  0  0  0  0  0  5  0  0  0  3  4
4  2  7  2  2  2  0  0  0  0  0  0  0 -5  0  0  3  3  3  3  0  0 -3  0  0  0  0  0 11  3  4
4  5 22  7  7  7  0  0  0  0  0  0  0  0  0  0  3  3  3  3  0  0  0  0  0  0  3  3  3  3  4
4  4  4  4  4  4  4  4  4  4  4  4  4  4  4  4  4  4  4  4  4  4  4  4  4  4  4  4  4  4  4