31 24
200 200
4  4  4  4  4  4  4  4  4  4  4  4  4  4  4  4  4  4  4  4  4  4  4  4  4  4  4  4  4  4  4
4 22  7  0  0  0  0  0  0  0  0  0  0  0  0  0  0  0  0  0  0  0  0  0  0  0  0  3  3  3  4
4  7  7  0  0  0  5  5  0  0  0  0  0  0  0  0  0  0  0 -5  0  0 -5  0  0  0  0  0  0  3  4
4  0  0  6  0  0  5  5  0  0  0 -5  0  0  0 -2  0  0  0  0  0  0  0  0  0  0 -3  0  0  3  4
4  0  0  0  0  0  0  0  0  0  0  0  0  0  0  0  0  0  0  0  0  0  0  0  0  0  0  0  0  3  4
4  0  3  3  3  0  3  0  3  3  0  0  2  2  2  2  2  2  0  0  0  0  0  0  0  0  0  0  0  0  4
4  0  3  3  3  0  3  0  0  0  0  0  2  2  2  2  2  2  0  0  0 -4  0  0  3  3  3  3  0  0  4
4  0  0  3  3  3  3  0  0 -3  0  0  2  2  2  2  2  2  0  0  0  0  0  0  3  3  3  3  0  0  4
4  0  0  0  3  3  3  0  0  0  0  0  0  0  2  2  2  2  2  2  0  0  0  0  3  3  0  0  0  0  4
4  0  0  0  0  0  0  0  0  0  2  2  2  2  2  2  2  2  0  0  0  0  0  0  3  3  0  0  0  0  4
4  0  0  0 -5  0  0  0  0  2  2  2  2  2  2  2  2  0  0  0  0  0  0  0  3  3  0  0  0  0  4
4  0  0  0  0  0  0  0  0  2  2  2  2  2  2  2  2  0  0  0  0  0  0  0  3  3  0 -2  0  0  4
4  0  0  0  0 -2  0  0  0  0  0  0  0  0  2  2  2  2  2  2  2  2  0  0  3  3  0  0  0  0  4
4  0  0  0  0  0  0  0  0  0 -4  0  0  0  2  2  2  2  2  2  2  2  0  0  3  3  0  0  0  0  4
4  0  0  0  0  1  1  0 -2  0  0  0  0  0  0  0 -2  0  0  0  0  0  0  0  0  0 -3  0  0  0  4
4  0 -5  0  1  1  1  1  0  0  3  0  0  0  0  0  0  0  0  0  0  0  0  0  0  0  0  0  0  0  4
4  0  0  0  1  1  1  1  1  0  3  2  2  0  0  0  0  0  0  0  0  1  0  0  0  0  0  0  0  0  4
4  0  0  0  0  0  0  0  3  3  3  2  2  0  0  0  3  3  3  3  3  0  0  0  0  0  0  0  0  3  4
4  0  0  0 -4  0  0  2  2  2  2  2  2  0  0  0  3  0  0  0  0  0  0 -1  0  0  0  0  0  3  4
4  0  0  0  0  0  0  2  2  2  2  2  2  0  0  0  3  0 -4  0  0  0  0  0  0  5  0  0  0  3  4
4  0  6  6  7  0  0  0  0  0  0  2  2  0  0  0  3  0  0  0  0  0  0  0  0  5  0  0  0  3  4
4  0  6  6  7  0 -5  0  0  0  0  0  0  0  0  0  3  3  3  3  0  0  0  0  0  0  0  0 11  3  4
4  0  0  0  0  0  0  0  0  0  0  0  0  0  0  0  3  3  3  3  0  0  0  0  0  0  3  3  3  3  4
4  4  4  4  4  4  4  4  4  4  4  4  4  4  4  4  4  4  4  4  4  4  4  4  4  4  4  4  4  4  4