25 19
200 200
4  4  4  4  4  4  4  4  4  4  4  4  4  4  4  4  4  4  4  4  4  4  4  4  4
4  7  0  0  0  0  0  0  0  0  0  0  0  0  0  0  0  0  0  0  0  2  2  0  4
4  7  7 -0  0  0  0  0  1  1  1 -0 -0  0  0  0  0 -0  0  0  0  2  2  0  4
4  7  7  0  0  0  5  0  0  0  0  0  0  0 -1  0  0  0  0  0  0  2  0  0  4
4  7  7  0  0  0  0  0  0  0  0  0  0  0  0  0  0  0  0  0  0  0  0  0  4
4  0  0  2  2  0  2  0 -1  0  0  0  0  0  0  0  0  0  0  0  0  0  0  0  4
4  0  0  2  2  0  2  0  0  0  0  0  0  0  0  0  0 -0  0  0  0  2  0  0  4
4  0  0  2  2  2  2  0  0  0  0  0  0  0  0  0  0  0  0  0  0  2  0  0  4
4  0  0  0  2  2  2  0  0  0  0  0  0  0  0  0  0  0  0  2  0  0  0  0  4
4  0  0  0  0  0  0  0  0  0  0  0  0  0  0  0  0  0  0  0  0 -2  0  0  4
4  0  11  0  0  0 0  6  6  6  6  6  6  6  6  6  6  6  6  0  0  0  0  0  4
4  0  0  0  0  0  0  0  0  0  0  0  0  0  0  0  0  0  0  0 -4  0  0  0  4
4  0  0  0 -0  0  0  0  0  3  3  3  3  0  0  0  0  0  0  0  0  0  0  0  4
4  0  0  0  0  3  3  3  3  3  3  3  3  3  3  0  0  0  0  0  0  0  6  0  4
4  0  0  6  6  1  1  0  0  0  0  0  0  0  0  0 -0  0  0 -0  6  6  6  0  4
4  0  0  0  1  1  1  1  0  0  0  0 -1  0  0  0  0  2  2  0  0  0  0  0  4
4  0  0  0  1  1  1  1  1  0  0  0  0  0  0  0 -1  2  2  0  0  6  0  0  4
4  0  0  0  0  0  0  0  0  0  0  0  0  0  0  0  0  7  7  0  0  0  0  0  4
4  4  4  4  4  4  4  4  4  4  4  4  4  4  4  4  4  4  4  4  4  4  4  4  4